1111111111111111111111111111111111
1E0000000000000C00000C000000000001
1010010100100000101001000000010101
10100100101010100010010K0000010101
1P0000K00C00C0000000000000000000C1
100000000000000C00000C000000000001
1010K10100100000101001000K00010101
1010010010101010001001000000010101
100000000C00C0000000000000000000C1
1111111111111111111111111111111111